----------------------------------------------------------------------------------------------------------------
--   ------          ---         --         ---                  ---      --  b   --               --         --
--   ------          ---                    --                    --      --      --               --         --
--   ------   --     ---         r          --          s         --  --  --  --  --  --           --         --
--   ------   --     ---  ----  ----  ----  --                    --  --  --  --  --  --       --v --v --     --
--            --          --     --     --                            --      --      --    --i--  s   --i--  e 
--       r    -- i        --  i     i   --         i  i   i   i       --  r   --  r   --    -----      -----    
----------------------------------------------------------------------------------------------------------------
